-------------------
|     |   |       |
+-+ + + +-+-+-+ + +
| | | |   |     | |
+ + +-+-+ +-+ + +-+
| |     |     |   |
+ + +-+ + +-+ +-+ +
|     |     |   | |
+-+ +-+-+ + + +-+-+
|   |     | | |   |
+ + + +-+-+ +-+ + +
| | |   |       | |
+-+-+ +-+-+-+-+ + +
|       |       | |
+------------------
