-----------
| |       |
+ +-+ +-+ +
|     | | |
+-+-+-+ + +
|     |   |
+-+-+ + +-+
|         |
+ + + +-+ +
| | |   | |
+----------
