-------------
|   | |     |
+ +-+ + +-+-+
|   | |     |
+-+ + + +-+ +
|         | |
+-+-+-+ +-+ +
|     | | | |
+-+-+ + + +-+
| |         |
+ + +-+-+-+-+
| |   |     |
+ +-+ +-+-+ +
|           |
+-+-+ +-+ + +
|     |   | |
+ +-+ + +-+ +
|   | |   | |
+------------
