-----------
|       | |
+-+ +-+ + +
|     |   |
+-+-+ + + +
|     | | |
+ + +-+-+ +
| |     | |
+ +-+ + +-+
|   | |   |
+----------
