-----------
| | |   | |
+ + + + + +
| |   |   |
+ + +-+ + +
|   |   | |
+ + + +-+-+
| | |   | |
+-+ + +-+ +
|   |     |
+----------
