-----------
|   |     |
+ +-+ +-+ +
|     |   |
+-+ +-+-+ +
| | | |   |
+ +-+ + +-+
|         |
+ + +-+-+ +
| | |     |
+----------
